p..m##.....#
###....###.r
.r..####p.m#
E.##r#r###..
.##..#.#.##.
m.##...#....
.#r##..m.#m#
.m..#.###..#
#.#m..#..r.#
.m...##...##
p.##.###.#X.
##p..#r....#

