###p#.......
r.#r..#.###X
..m.##..rr##
##....m###.p
p#...#......
m###.p#.##m#
...m..#.#..#
m###.......#
r#.m....##.#
##.####.##..
#E.#..m.##.r
####r.######

