.p#.#.E##.##
..#r.m....##
.##..##...##
....#r.m..##
m#.###.##m.#
.r###p.p#..#
.r#..#.##..#
#.#..##r..##
#..m.....m.r
..m#....#..#
.#...#####.#
m..r...X##.p

