####.#r.#.p#
r###..#.#..#
.#..#.....##
..#...##..##
#.#...####r#
..#.#.m.r.m.
m...#.##..#.
.##.mp#pm.X.
r#r#####.##r
.m..##...###
m#m#.##.####
p#E..#######

