p#r#.p.##....
.#.#...##..r.
.e.###.e.....
#.###%#.####.
#%##%%%%%%%#.
#%%#%##%#%##.
#%%%%.##.%%%.
#..%#..#..##.
#####.#...e..
#..e.....#...
#r.#.###e#.p.
#..e.#p..###.
