%%%#r##e...#.
#%##.#..#pp#.
#%%%%%%..###.
%%%%##%.####.
%%%%##%##r##.
%##%##%%#....
#e###re%.#e..
...###p%%%.#.
##r...e##%%r.
###.#####%%..
##.e..p#X#%#.
r..#..##...#.
