.p#.#.%##.##.
..#r.e%%..##.
.##..##%..##.
....#r%%..##.
e#.###%##e.#.
.r###p%%#..#.
.r#..#%##..#.
#.#..##r..##.
#..e.....e.r.
..e#....#..#.
.#...#####.#.
e..r...X##.p.
