###p#.....%%%
r.#r..#.###%%
..e.##..rr##%
##....e###%%%
p#...#.%%%%%%
e###.p#%##%#%
...e..#%#..#%
e###%%%%...#.
r#%%%%..##.#.
##%####.##...
#%%#..e.##.r.
####r.######.
