###p#........
%%#%..#%###X.
%%%%##%%%%##.
##%%%%%###.p.
p#%%%#%%%....
%###%%#%##e#.
%%%%%%#%#..#.
e###%%%%...#.
r#%%%%%.##.#.
##%####.##...
#%%#..e.##.r.
####r.######.
