p#r...###r.#
.##...p#...#
.....e#....r
#..##...#..#
r###%..##e.#
e%%%%#...%##
#%#%#%%##%##
#%#%##%%%%##
%%%%%%%#%%%%
%%%######%%%
%#.#########
%.p#########
