####.#r.#.p#
r###..#.#..#
.#..#.....##
..#...##..##
#.#%%%####r#
..#%#%%.r.e.
%%%%#.##..#.
%##.ep#pe.X.
%#r#####.##r
%%%.##...###
e#%#.##.####
p#%..#######
