###%#%%.....
r.#%%%#.###X
..%%##%%rr##
##%%%%%###.p
p#%%%#%%....
e###%%#%##e#
%%%%%%#%#..#
e###%%%%%%.#
r#%%%%%%##.#
##%####.##..
#%%#..e.##.r
####r.######
