.p#%#%%##%##.
..#%%%%%%%##.
.##%%##%%%##.
....#%%%%%##.
e#.###%##%.#.
.r###%%%#%%#.
.r#..#.##%%#.
#.#..##%%%##.
#..e...%.e.r.
..e#%%%%#..#.
.#..%#####.#.
e..r%%%%##.p.
