p#r...###r.#
.##...p#%%.#
.....e#%%%.r
#..##%%%#%%#
r###%%%##%%#
e.%%%#%%%%##
#.#%#%%##%##
#r#%##%%%%##
.e.%%%%#%%%%
...######%%%
.#.#########
X.p#########
