####.#r.#.p#.
r###..#.#..#.
.#..#.....##.
..#...##..##.
#.#..%####r#.
..#.#%%%%.e..
%%%%#%##%%#..
%##%%%#p%%%..
%#%#####.##r.
%%%%##...###.
e#%#.##.####.
p#%..#######.
