%######%%#%%
%#%%%%%%%#%.
%#%%%%#%##%%
%#%####%%#%%
%%%%%%##%#%%
%#%%%%%%%%%%
%########%##
%#r.r#p.#.p#
%#...#..#r.#
%##e###e##.#
%...#X#....#
###...e.####
