p#r...###%.#
.##...p#%%%#
.....e#%%%%%
#..##.%%#%%#
r###..%##%.#
e.e..#%%%%##
#.#.#%%##%##
#r#.##%%%%##
.e..e.r#%%%%
...######%%%
.#.#########
X.p#########
