###p#.......
r.#r..#.###X
.%%.##..rr##
##%%%%%###.p
p#%%%#%%%%%.
e###%%#%##%#
...%%%#%#%%#
e###.%%%%%%#
r#%%%%%%##%#
##%####%##..
#%%#%%%%##.r
####%%######
