####.#r.#.p#
%###..#.#..#
%#%%#.....##
%%#%%%##..##
#%#%%%####r#
%%#%#%%.r.e.
%%%%#.##..#.
%##.ep#pe.X.
%#%#####.##r
%%%%##...###
%#%#.##.####
%#%%.#######
