####.#r.#.p#.
r###..#.#..#.
.#..#.....##.
..#...##..##.
#.#..%####r#.
%%#%#%%%%.e..
%%%%#%##%.#..
%##%%%#p%.X..
%#%#####.##r.
%%%%##...###.
%#%#.##.####.
%#%%.#######.
