%%%#r##%%%%#.
#%##.#%%#%%#.
#%.%%%%..###.
%%.%##..####.
%%%%##.##r##.
r##.##..#....
#e###re..#e..
...###pe...#.
##r...e##..r.
###.#####....
##.e..p#X#e#.
r..#..##...#.
