#####%%#####
####%#%####r
##%#%%%%ep#%
##%#%#%%#%%%
##%%%#%%%%%%
##%%#%%%%%%%
r###e%#%###%
..##.###eX##
..r#.....###
##..e###e###
#pe.####r###
##....######
