%%%#%##%%..#.
#%##%#%%#pp#.
#%%%%%%%.###.
%%%%##%.####.
%%%%##%##r##.
%##%##%%#.%..
#e###r%%%#%..
...###%%%%%#.
##r..%%##%%%%
###.#####%...
##.e..p#X#e#.
r..#..##...#.
