p..e##%%%%%#%
###%%%%###%%%
%%%%####%%%#%
%%##r#r###%%%
%##..#.#.##%%
%%##...#%%%%%
%#r##..e.#%#%
.e..#.###%%#.
#.#e..#.%%%#.
.e...##.%%##.
p.##.###.#X..
##p..#r....#.
