p..e##.....#
###....###.r
.r..####p.e#
%.##r#r###..
%##..#.#.##.
%%##...#....
%#%##..e.#e#
%%%%#%###..#
#%#%%%#..r.#
.%%%%##...##
p%##%###.#X.
##%%%#r....#
