#####r.#####.
####.#e####r.
##%#%%%.ep#r.
##%#%#%%#%...
##%%%#.%%%%%.
##p.#%%%%%%%.
r###e.#%###%.
..##.###eX##.
..r#.....###.
##..e###e###.
#pe.####r###.
##....######.
