%%%#%##%%%%#.
#%##%#%%#%%#.
#%%%%%%%%###.
%%%%##%%####.
%%%%##%##r##.
%##%##%%#....
#%###%%%%#e..
%%%###%%%..#.
##%%%%%##..r.
###%#####....
##.%..p#X#e#.
r..#..##...#.
