#####r.#####.
####.#e####r.
##%#....ep#r.
##%#e#..#....
##%%%#.......
##%%#........
r###e.#r###p.
..##.###eX##.
..r#.....###.
##..e###e###.
#pe.####r###.
##....######.
