p..e##%%%%%#.
###%%%%###%r.
.%%%####p.%#.
%%##r#r###%%%
.##..#.#.##.%
e.##...#....%
.#r##..e.#e#%
.e..#.###..#%
#.#e..#..r.#%
.e...##...##%
p.##.###.#%%%
##p..#r....#.
