####.#r.#.p#.
r###..#.#..#.
.#..#.....##.
..#.%%##..##.
#.#%%%####r#.
%.#%#%%%%.e..
%%%%#.##%.#..
%##.ep#p%.X..
%#%#####.##r.
%%%%##...###.
%#%#.##.####.
%#%..#######.
