%%#.#%%##.##
%%#%%%....##
%##%%##...##
%%%%#r.e..##
%#%###.##e.#
%%###p.p#..#
%%#..#.##..#
#%#..##%%.##
#%%%%%%%%%.r
%%%#%%%.#..#
.#...#####.#
e..r...X##.p
