%#%#.p.##....
%#%#...##..r.
%%%###.e.....
#%###%#.####.
#%##%%..e.r#.
#%%#%##r#e##.
#%%%%%##.%.X.
#%%%#%%#%%##.
#####%#%%%%..
#%%%%%%%%#...
#%%#%###e#.p.
#%%%%#p..###.
