###p#%%%%%%%.
r.#%%%#%###%.
..e%##.%%r##.
##.%%%%###.p.
p#...#%%.....
e###.p#%##e#.
...e..#%#..#.
e###..%%...#.
r#%%%%%%##.#.
##%####.##...
#%%#..e.##.r.
####r.######.
