####.#r.#.p#.
%###..#.#..#.
%#%%#.....##.
%%#%%%##..##.
#%#%..####r#.
%%#%#.e.r.e..
%%%%#.##..#..
%##%ep#pe.X..
%#%#####.##r.
%%%%##...###.
%#%#%##.####.
%#%%%#######.
