%#r#.p.##...
%#.#...##..r
%%.###.e....
#%###r#.####
#%##....e.r#
#%%#%##r#e##
#%%%%%##...X
#.%r#..#..##
#####.#...e.
#..e.....#..
#r.#.###e#.p
#..e.#p..###
