p#%%%%###r.#
.##%%%p#...#
.%%%%%#..%%%
#%%##%%.#%%#
r###.%%##%%#
e.e..#%%%%##
#.#.#p%##%##
#r#.##%%%%##
.e..e.r#%%%%
...######%%%
.#.#########
X.p#########
