r######.r#%%%
.#.......#%%%
.#....#e##%%%
e#e####pp#%%%
......##e#%%%
r#.......%%%%
.########e##%
.#r.r#p.#.p#%
.#...#..#r.#%
r##e###e##.#%
....#X#....#%
###...e.####%
