p#r...###r.#
.##...p#...#
.....e#....r
#..##%..#%%#
r###%%%##%.#
%%%%%#%%%%##
#%#%#%%##%##
#%#%##%%%%##
.%.%e.r#%%%%
...######%%%
.#.#########
X.p#########
