.p#.#.%##%##.
..#r.e%%%%##.
.##..##%%%##.
....#%%%%%##.
e#.###%##%%#.
.r###%%%#%.#.
.r#..#%##%%#.
#.#..##%%%##.
#..e%%%%%%.r.
..e#%%%%#..#.
.#...#####.#.
e..r...X##.p.
