#%%%%.r#####
%#%%####%...
%%%%#%##%##X
#%#%%%#%%#r.
###%#%#%##.#
##%%%%%%##e#
pe%#%%%#%%.r
#..##%%#%..r
##r###%%%#.#
#r###..###p#
..#.e.######
.....#######
