###p#........
r.#r..#.###%%
..e%##..rr##%
##%%%%%###%%%
p#.%%#%%%%%%%
e###%%#%##e#%
...e%%#%#..#%
e###%%.....#%
r#%%%%..##.#%
##%####.##...
#%%#..e.##.r.
####r.######.
