####.#r.#.p#
r###..#.#..#
%#..#.....##
%%#%%%##..##
#%#%%%####r#
%%#%#%e.r.e.
%%%%#%##..#.
%##%%%#pe.X.
%#%#####.##r
%%%%##...###
e#%#%##.####
p#%%%#######
