#####r.#####.
####.#e####r.
##%#%%%.ep#r.
##%#%#%%#%...
##%%%#%%%%...
##%%#%%%%%...
r###%%#%###p.
..##%###%X##.
..r#%%%%%###.
##.%%###e###.
#pe%####r###.
##....######.
