#####r.#####
####%#%####%
##%#%%%%e%#%
##%#%#%%#%%%
##%%%#%%%%%%
##%%#%%%%%%%
r###e.#%###%
..##.###eX##
..r#.....###
##..e###e###
#pe.####r###
##....######
