p#%#.p.##...
.#%#...##..r
.%%###.e....
#%###r#.####
#%##....e.r#
#%%#%##r#e##
#%%%%%##...X
#%%%#%%#..##
#####%#...e.
#%%%%%...#..
#%%#%###e#.p
#%%%%#p..###
