.%%#%##e...#.
#%##%#..#pp#.
#%.%%%%%%###.
.%%%##%%####.
%%%.##%##r##.
%##.##%%#....
#e###%%%%#e..
...###%e%%.#%
##r.%%%##%%%%
###.#####%%%%
##.e..p#%#%#%
r..#..##%%%#.
