%#%#.p%##%%%
%#%#..%##%%%
%%%###%%%%%%
#%###%#%####
#%##%%%%e.r#
#%%#%##r#e##
#%%%%.##...X
#%%%#..#..##
#####.#...e.
#..e.....#..
#r.#.###e#.p
#..e.#p..###
