r######.%#%%
.#%%%%%%%#%%
.#%%%%#e##%%
e#%####p%#%%
..%%%%##%#%%
r#%.%%%%%%%%
.########%##
.#r.r#p.#%p#
.#...#..#%.#
r##e###e##.#
....#X#....#
###...e.####
