##r..#####.p.
####.#%###...
#.r#.#%%%#...
#e#.e.%#%%.#.
p...#%%##%##.
#e##%%#p#%e..
.%%%%##e#%#r.
%%##%##..%##.
.%##%#%#%%##.
#%%##%%#%###.
#%%%%%.#%###.
######.#%%##.
