p#r#.p.##....
.#.#...##..r.
.e.###.e.....
#%###r#.####.
#%##....e.r#.
#%%#%##r#e##.
#%%%%%##%%.X.
#.%r#%%#%%##.
#####%#%%%%%.
#%%%%%%%%#%..
#%%#%###%#.p.
#%%%%#%%%###.
