###p#.......
r.#r..#.###X
..e.##..rr##
##....%###%%
p#..%#%%.%%%
e###%%#%##%#
.%%%%%#%#%%#
e###%%%%%%%#
r#%%%%%%##%#
##%####%##..
#%%#..e.##.r
####r.######
