#####r.#####.
####.#e####r.
##%#%%%.ep#r.
##%#%#%%#....
##%%%#.%.....
##%%#..%%%...
r###e.#%###p.
..##.###eX##.
..r#.....###.
##..e###e###.
#pe.####r###.
##....######.
