p#r#.%%##....
.#.#%%%##..%%
.e.###%%%%%%%
#.###%#%####%
#.##%%%%e.r#%
#.%#%##%#e##%
#.%%%.##...%%
#.%%#..#..##.
#####.#...e..
#..e.....#...
#r.#.###e#.p.
#..e.#p..###.
