.p#.#%%##%##.
..#r.e%%%%##.
.##..##%%%##.
....#%%%%%##.
e#.###.##%%#.
.r###p.p#%%#.
.r#..#.##%%#.
#.#..##%%%##.
#.%%%%%%%%%r.
..e#%%%%#%%#.
.#%%%#####.#.
e.%%%%%%##.p.
