%%%#r##%%%%#.
#%##.#%%#%%#.
#%.%%%%%%###.
.%%%##%%####.
....##%##r##.
r##.##%%#....
#e###%%%.#e..
...###%%...#.
##r.%%%##..r.
###.#####....
##.e..p#X#e#.
r..#..##...#.
