p#r...###%%#
.##...p#%%%#
.....e#%%%%%
#..##%%%#%%#
r###.%%##%%#
e.e..#%%%%##
#.#.#%%##%##
#r#.##..%%##
.e..e.r#%%.r
...######%..
.#.#########
X.p#########
