####.#r.#.p#.
r###..#.#..#.
.#..#.....##.
..#...##..##.
#.#%%%####r#.
.%#%#%%%%.e..
%%%%#.##%%#..
%##.ep#pe%%..
%#%#####.##r.
%%%%##...###.
e#%#.##.####.
p#%..#######.
