###p#..%%%%%
r.#r..#%###%
..e.##%%rr##
##..%%%###.p
p#..%#......
e###%p#.##e#
...e%.#.#..#
e###%......#
r#%%%...##.#
##%####.##..
#%%#..e.##.r
####r.######
