p#r#.p.##...
.#.#...##..r
.e.###.e....
#.###r#.####
#%##....e.r#
#%%#.##r#e##
#%%%%%##...X
#%%%#%%#..##
#####%#...e.
#%%%%%%..#..
#%%#%###e#.p
#%%%%#p..###
