#####r.#####.
####.#e####r.
##%#%%%%%%#r.
##%#%#..#%%..
##%%%#..%%%%.
##p.#..%%%%%%
r###e.#r###%%
..##.###eX##%
..r#.....###%
##..e###e###.
#pe.####r###.
##....######.
