p#r...###r.#.
.##...p#...#.
.....e#....r.
#..##...#..#.
%###...##e.#.
%%%%.#%%..##.
#%#%#p%##.##.
#%#%##%%%%##.
.%.%%%%#.%%r.
...######%...
.#.#########.
X.p#########.
