p#r#.p.##%%..
.#.#...##%%%%
.e.###.%%%..%
#.###%#%####%
#.##%%%%e.r#%
#%%#%##%#e##%
#%.%%%##...%%
#%%%#%.#..##.
#####.#...e..
#..e.....#...
#r.#.###e#.p.
#..e.#p..###.
