p..e##.....#
###....###.r
.r..####p.e#
%.##r#r###..
%##..#.#.##.
%.##...#%%%.
%#r##%%%%#%#
%%%%#%###.%#
#.#%%%#..%%#
.e...##.%%##
p.##.###%#%.
##p..#r.%%%#
