%#%#.%%##...
%#%#.%%##..r
%%%###%%%...
#%###r#%####
#%##%%%%e.r#
#%%#%##%#e##
#%%%%%##...X
#%%%#%%#..##
#####%#...e.
#..e.....#..
#r.#.###e#.p
#..e.#p..###
