p#r#.p.##...
.#.#...##..r
.%.###.%....
#%###%#%####
#%##%%%%%%r#
#%%#%##r#e##
#%%%%%##...X
#%%%#..#..##
#####.#...e.
#..e.....#..
#r.#.###e#.p
#..e.#p..###
