r######.r#%%.
.#.......#%..
.#....#e##%..
e#e####pp#%..
%%%%%%##e#%%%
%#%%%%%%%%%%%
%########e##%
%#r.r#p.#.p#.
%#...#..#r.#.
%##e###e##.#.
%%%%#%#....#.
###%%%e.####.
