###p#%%%%%%%.
r.#%%%#%###%.
..e%##%%%%##.
##.%..%###.p.
p#.%%#.......
e###%%#.##e#.
...e.%#.#..#.
e###%%%....#.
r#%%%%%.##.#.
##%####.##...
#%%#..e.##.r.
####r.######.
