###p#..%%%%%
r.#r..#%###%
..e.##%%rr##
##....%###%%
p#..%#%%..%%
e###%%#%##%#
...%%%#%#%%#
e###%%%%%%%#
r#%%%%%%##.#
##%####.##..
#%%#..e.##.r
####r.######
