r######.r#%%
.#.......#%%
%#....#e##%%
%#%####%%#%%
%%%%%%##%#%%
%#%%%%%%%%%%
%########e##
%#r.r#p.#.p#
%#...#..#r.#
%##e###e##.#
%%%%#X#....#
###...e.####
