#####r.#####.
####.#e####r.
##%#%%%%e%#r.
##%#%#.%#%...
##%%%#%%.%%..
##%%#.%%%%%%.
r###e.#r###%%
..##.###eX##.
..r#.....###.
##..e###e###.
#pe.####r###.
##....######.
