#####r.#####%
####%#e####%%
##%#%%%%%%#%%
##%#%#%%#%%%%
##%%%#%%%%%%%
##%%#%%%%%%%.
r###%%#%###%.
..##.###eX##.
..r#.....###.
##..e###e###.
#pe.####r###.
##....######.
