r######.r#%%
.#.......#%%
.#....#e##%%
e#e####pp#%%
......##%#%%
r#....%%%%%%
.########%##
.#r.r#p.#%p#
.#...#..#%%#
r##e###e##.#
....#X#....#
###...e.####
