#####r.#####
####.#%####%
##%#%%%%%%#%
##%#%#%%#%%%
##%%%#%%%%%%
##%%#%%%%%%%
r###%%#%###p
..##%###eX##
..r#%....###
##..e###e###
#pe.####r###
##....######
