p..e##.....#.
###....###.r.
%%..####p.e#.
%%##r#r###...
%##..#.#.##..
%%##...#.....
%#r##%%%.#e#.
%%..#%###..#.
#%#%%%#..r.#.
.%%%%##...##.
p.##.###.#X..
##p..#r....#.
