#####r.#####.
####.#e####%.
##%#%%%.ep#%.
##%#%#%.#.%%.
##%%%#%%..%%.
##%%#%%%%%%%.
r###%%#%###%.
..##%###%%##.
..r#%%%%%###.
##..e###e###.
#pe.####r###.
##....######.
