.p#.#.%##.##
..#r.e%%%%##
.##..##..%##
....#r.e.%##
e#.###.##%.#
.r###p.p#%.#
.r#..#.##%.#
#.#..##r.%##
#..e...%%%.r
..e#%%%%#..#
.#..%#####.#
e..r%%%%##.p
