r######.r#%%
.#.......#%%
.#....#e##%%
e#e####p%#%%
......##%#%%
r#.....%%%%%
.########e##
.#r.r#p.#.p#
.#...#..#r.#
r##e###e##.#
....#X#....#
###...e.####
