p#r#.p.##...
.#.#...##..r
.%%###.%....
#%###%#%####
#%##%%%%%%%#
#%%#%##%#%##
#%%%%%##%%.X
#%%%#%%#%.##
#####%#%%.e.
#..e%%%%.#..
#r.#.###e#.p
#..e.#p..###
