#####r.#####
####.#e####r
##%#....ep#r
##%#e#..#...
##%..#......
##p.#.......
r###e.#r###p
..##.###eX##
..r#.....###
##..e###e###
#pe.####r###
##....######
