###p#.......
r.#r..#.###X
..e.##..rr##
##%%%%e###.p
p#.%%#.%%...
e###%%#%##e#
%%%%%%#%#..#
e###%%%%%..#
r#%%%%%%##.#
##%####%##..
#%%#..%%##.r
####r.######
