%%%#r##e...#
#%##%#..#pp#
#%%%%%%..###
%%%%##%%####
%%%%##%##%##
r##%##%%#%%%
#e###r%%%#%%
...###%%%%%#
##r...e##%%%
###.#####%%%
##.e..p#%#%#
r..#..##%%%#
