p#r#.p.##%%%%
.#.#...##%%%%
.e.###%%%%%%%
#.###r#%####%
#.##%%%%%.r#%
#%%#%##r#e##.
#%%%%%##...X.
#%%%#%.#..##.
#####%#...e..
#..e.....#...
#r.#.###e#.p.
#..e.#p..###.
