###p#.......
r.#r..#.###X
..e.##..rr##
##....%###%%
p#...#%%%%%%
e###%%#.##%#
...e%%#%#%%#
e###%%%%%%%#
r#%%%%%%##%#
##%####%##%%
#%%#%%%%##%%
####%%######
