##r..#####.p.
####.#%###...
#.r#.#%%%#...
#e#.e%%#%%.#.
p...#%.##%##.
#e##%%#%#%e..
%%%%%##%#%#r.
%.##%##%%%##.
%%##%#%#%%##.
#%%##%%#%###.
#.%%%%.#%###.
######.#%%##.
