r######.r#%%
.#.......#%%
.#%...#e##%%
e#%####pp#%%
.%%%%%##e#%%
r#%%%%%%%%%.
.########%##
.#r.r#p.#%%#
.#...#..#%%#
r##e###e##%#
....#X#....#
###...e.####
