.p#.#.%##.##
..#r.e%%%%##
.##..##.%%##
....#%%%%%##
e#.###%##%%#
.r###p.p#%%#
.r#..#.##%%#
#.#..##%%%##
#..e%%%%%%%%
.%%#%%%%#%%#
.#%%%#####%#
e%%%%%%%##%%
