#%%%%%%#####.
%#%%####.....
%%%%#p##.##X.
#%#%%%#..#r..
###%#%#%##.#.
##%%%%%%##e#.
%%%#%%%#...r.
#%%##%%#e..r.
##%###%..#.#.
#r###..###p#.
..#.e.######.
.....#######.
