p#r...###r.#.
.##...p#...#.
.....e#.%%.r.
#..##%%.#%%#.
r###%%%##%%#.
%%%%%#%%%%##.
#%#%#pe##%##.
#%#.##.%%%##.
.%..e.r#%%%%.
...######%%%%
.#.#########.
X.p#########.
