p..%##%%%%%#
###%%%%###%r
%%%%####p.%#
%%##r#r###%%
.##..#.#%##%
e.##...#%%%%
.#r##..%%#%#
.e..#.###%%#
#.#e..#..%%#
.e...##...##
p.##.###.#X.
##p..#r....#
