###p#.......
r.#r..#.###X
.%%%##..rr##
##%%%%%###%%
p#%%%#%%%%%%
e###%%#%##%#
..%%%%#%#%%#
e###%%%%%%%#
r#%%%%%%##%#
##%####.##%%
#%%#..e.##%%
####r.######
