p..e##.....#
###%...###.r
%%%%####p.e#
%%##r#r###..
%##..#.#.##.
%.##...#....
%#%##..e.#e#
%%%%#.###..#
#%#%%.#..r.#
%%%%%##...##
%%##%###.#X.
##%%%#r....#
