r######%%#%%
.#%%%%%%%#%%
.#%%%%#%##%%
e#%####%%#%%
.%%%.%##%#%%
r#%%%%%%%%%%
.########%##
.#r.r#p.#%%#
.#...#..#r.#
r##e###e##.#
....#X#....#
###...e.####
