.%%#%##e...#.
#%##%#..#pp#.
#%.%%%%..###.
%%%%##%.####.
%%..##%##r##.
%##.##%%#....
#e###re%%#e..
...###pe%%%#.
##r...e##.%%%
###.#####.%%%
##.e..p#%#%#.
r..#..##%%%#.
