####.#r.#.p#.
r###..#.#..#.
.#..#.....##.
..#...##..##.
#.#...####r#.
..#.#%%%%.e..
%%%%#%##%%#..
%##%%%#pe%%..
%#%#####.##r.
%%%%##...###.
e#%#.##.####.
p#%%.#######.
