.p#%#%%##%##
..#%%%%%%%##
.##%%##%%%##
%%%%#%%%%%##
e#.###%##e.#
.r###p.p#..#
.r#..#.##..#
#.#..##r..##
#..e.....e.r
..e#....#..#
.#...#####.#
e..r...X##.p
