%%%#%##e...#.
#%##%#..#pp#.
#%%%%%%%.###.
%%%%##%%####.
%%%%##%##r##.
%##%##%%#....
#e###r%%%#e..
...###%%%..#.
##r%%%%##..r.
###%#####....
##.%%%%#X#e#.
r..#%%##...#.
