#%%.e.r#####.
p#%%####.....
..%%#p##.##X.
#.#%%%#..#r..
###%#%#.##.#.
##%%%%%.##e#.
p%%#%%.#...r.
#%%##..#e..r.
##%###...#.#.
#r###..###p#.
..#.e.######.
.....#######.
