p#r#.p.##....
.#.#...##..r.
.e.###.e.....
#.###%#%####.
#%##%%%%%%r#.
#%%#%##%#%##.
#%%%%%##%%%%.
#%%%#..#%%##.
#####.#..%%%%
#..e.....#%%%
#r.#.###e#%%%
#..e.#p..###.
