p#r...###r.#
.##...p#%%%#
.....e#.%%%%
#..##%%%#%%#
r###.%%##%%#
e.e..#%%%%##
#.#.#%%##%##
#r#.##%%%%##
.e..e.%#%%%%
...######%%%
.#.#########
X.p#########
