r######.r#%%
.#.......#%%
.#....#e##%%
e#e####pp#%%
......##e#%%
r#......%%%%
.########%##
.#r.r#p.#%p#
.#...#..#%.#
r##e###e##.#
....#X#....#
###...e.####
