##r..#####.p.
####.#r###...
#.r#.#..%#%..
#e#.e..#%%%#.
p...#..##%##.
#e##..#%#%%%.
.....##%#%#%%
r.##.##%%%##%
..##r#X#%%##%
#ep##..#%###%
#...e..#%###.
######.#%%##.
