p#r#.p.##....
.#.#...##..r.
.e.###.e.....
#.###r#.####.
#.##%%%%%%r#.
#.%#%##r#%##.
#.%%%%##.%%%.
#..r#%.#..##.
#####%#...e..
#..e.....#...
#r.#.###e#.p.
#..e.#p..###.
