.p#.#%%##%##
..#r%%%%%%##
.##..##%%%##
....#r.%%%##
e#.###.##%%#
.r###p.p#%%#
.r#%%#.##%%#
#.#%%##%%%##
#..e%%%%%e.r
..e#%%%%#..#
.#.%%#####.#
e..%%%%%##.p
