p#r...###r.#
.##...p#.%.#
.....e#.%%%%
#..##%%.#%%#
r###%%%##%%#
e.%%%#%%%%##
#.#%#%%##%##
#r#%##%%%%##
.e%%e.r#%%%%
...######%%.
.#.#########
X.p#########
