p#r...###r.#.
.##...p#...#.
.....e#....r.
#..##...#..#.
%###...##e.#.
%%%..#....##.
#%#%#pe##.##.
#%#%##%%%%##.
.%%%%%%#%%%%%
.%%######%%%.
.#.#########.
X.p#########.
