#####%%#####
####%#%####r
##%#%%%.ep#r
##%#%#%%#%..
##%%%#%%%%%.
##%%#%%%%%..
r###%%#%###p
..##%###eX##
..r#%....###
##.%%###e###
#p%%####r###
##%%%%######
