####.#r.#.p#
%###..#.#..#
%#..#.....##
%%#...##..##
#%#%..####r#
%%#%#%%%%%%.
%%%%#%##..#.
%##%%%#pe.X.
%#%#####.##r
%%%%##...###
%#%#.##.####
%#%..#######
