#####%%#####
####.#%####r
##%#%%%%%%#r
##%#%#%%#%..
##%%%#%%%%..
##%%#%%%%%%.
r###e%#%###p
..##.###eX##
..r#.....###
##..e###e###
#pe.####r###
##....######
