#%%%e.r#####.
p#%%####%%%%%
..%%#%##%##%%
#.#%%%#%%#r..
###%#%#%##.#.
##.%%%%%##e#.
pe.#%%%#...r.
#..##%%#e..r.
##r###...#.#.
#r###..###p#.
..#.e.######.
.....#######.
