p%%%##%%%%%#
###%%%%###%%
.%%%####%%%#
%%##r#r###%%
.##..#.#%##%
e.##%%%#%%%%
.#%##%%%%#e#
.%%%#%###..#
#.#%%%#..r.#
.e.%%##...##
p.##%###.#X.
##p%%#r....#
