###%#.......
%%#%%%#.###X
%%%%##..rr##
##.%%.e###.p
%#.%%#......
%###%%#.##e#
%%%%%%#.#..#
%###%%%%...#
%#%%%%%.##.#
##%####.##..
#%%#..e.##.r
####r.######
