p..e##.....#
###....###.r
%%%.####p.e#
%%##r#r###..
.##..#.#.##.
e.##...#....
.#r##..e.#e#
.e..#.###..#
#.#e..#..r.#
.e...##...##
p.##.###.#X.
##p..#r....#
