#%%%%%%#####
p#%%####....
.%%%#p##.##X
#%#%%.#..#r.
###%#.#.##.#
##%%%.e.##e#
%%%#%..#...r
#%%##..#e..r
##r###...#.#
#r###..###p#
..#.e.######
.....#######
