%%%#r##e...#
#%##%#%.#pp#
#%%%%%%%%###
%%%%##%%####
%%%%##%##r##
%##%##%%#...
#e###r%%%#e.
...###pe...#
##r...e##..r
###.#####...
##.e..p#X#e#
r..#..##...#
