r######%%#%%
.#....%%%#%%
.#....#%##%%
e#e####%%#%%
......##%#%%
r#......%%%%
.########%##
.#r.r#p.#.p#
.#...#..#r.#
r##e###e##.#
....#X#....#
###...e.####
