p..e##%%%%%#%
###%%%%###%%%
%%%%####%%%#%
%%##r#r###%%%
%##..#.#.##%%
%%##...#...%%
%#%##..e.#e#.
%%%%#.###..#.
#%#e..#..r.#.
%%%..##...##.
%%##.###.#X..
##p..#r....#.
