p#r...###r.#
.##...p#...#
.....e#%.%%r
#..##%%%#%%#
r###%%%##%.#
e%%%%#%%%%##
#%#.#pe##%##
#%#.##..%%##
%%%.e.r#%%%%
%..######%%%
%#.#########
%.p#########
