#%%%%%%#####
p#%%####....
..%%#%##.##X
#.#%%%#..#r.
###%#%#.##.#
##%%%.e.##e#
%%%#%%.#...r
#%%##%%#%..r
##%###%%%#.#
#r###..###p#
..#.e.######
.....#######
