###%#.......
r.#%..#.###X
..%%##..rr##
##%%%.%###%%
p#%%%#%%%%%%
%###%%#%##%#
%%%%%%#%#%%#
%###%%%%%%%#
r#%%%%%%##%#
##%####.##%.
#%%#..e.##.r
####r.######
