p#r#.p.##...
.#.#...##..r
.e.###.e....
#.###%#.####
#.##%%..e.r#
#.%#%##r#%##
#.%%%%##%%%%
#.%%#%%#%%##
#####%#%%%%%
#..e.%%%%#%%
#r.#.###%#%%
#..e.#p..###
