%%%#r##e...#.
#%##%#%.#pp#.
#%%%%%%%%###.
%%%%##%%####.
%%%%##%##r##.
%##%##%%#....
#e###r%%%#%..
...###%%%%%#.
##%%%%%##%%%.
###.#####%%%.
##.e..p#X#%#.
r..#..##.%%#.
