.p#.#.%##.##.
..#%%%%...##.
.##%.##...##.
%%%%#r.e..##.
%#.###.##e.#.
%r###p.p#..#.
%%#..#.##..#.
#%#..##r..##.
#%.e.....e.r.
.%%#....#..#.
.#%%%#####.#.
e..r%%%%##.p.
