#####r.#####
####%#e####%
##%#%%%%%%#%
##%#%#%%#%%%
##%%%#%%%%%%
##%%#%%%..%%
r###%%#%###p
..##%###eX##
..r#%%%%.###
##..%###e###
#pe.####r###
##....######
