###%#%%......
r.#%%%#.###X.
%%%%##..rr##.
##%%..e###.p.
p#%%%#.......
e###%%#%##e#.
..%%%%#%#..#.
e###%%%%...#.
r#%%%%%%##.#.
##%####%##...
#%%#%%%%##.r.
####%%######.
