###p#.......
r.#r..#.###X
..e.##..rr##
##....%###%%
p#...#%%%%%%
e###.p#%##%#
...e..#%#%%#
e###..%%.%%#
r#%%%%%%##.#
##%####%##..
#%%#.%%%##.r
####r.######
