##r..#####%%
####.#%###%%
#.r#.#%%%#%%
#e#.e%%#%%%#
p...#.%##%##
#e##..#p#%%%
.....##e#%#r
r.##.##.%%##
..##r#X#%r##
#ep##..#%###
#...e..#%###
######.#%%##
