p#r#.p.##...
.#%#...##..r
.%%###.e....
#%###r#.####
#%##%...e.r#
#%%#%##r#e##
#%%%%%##...X
#%%%#%.#..##
#####.#...e.
#..e.....#..
#r.#.###e#.p
#..e.#p..###
