p#%%%%###r.#.
.##%%%%#...#.
...%%%#....r.
#..##%%%#..#.
r###.%%##e.#.
e.e..#%%..##%
#.#.#%%##.##%
#r#.##%%%%##%
.e%%%%%#%%%%%
%%%######%%%%
%#%#########.
%.%#########.
