####.#r.#.p#.
r###..#.#..#.
.#..#.....##.
..#...##..##.
#.#...####r#.
%%#.#.e.r.e..
%%%.#.##..#..
%##.ep#pe.X..
%#%#####.##r.
%%%%##...###.
e#%#%##.####.
p#%%%#######.
