#%%.e.r#####.
p#%.####.....
..%%#%##.##%%
#.#%%%#..#r.%
###%#%#.##.#%
##.e.%e.##e#%
pe.#.%%#.%%%%
#..##%%#%%.%%
##r###%%%#.#.
#r###..###p#.
..#.e.######.
.....#######.
