p#r#.p.##....
.#.#...##..r.
.%.###.e.....
#%###%#%####.
#%##%%%%%.r#.
#%%#%##%#e##.
#%%%%%##...X.
#%%%#%%#..##.
#####%#...e..
#%%%%%%..#...
#%%#%###e#.p.
#%%e%#p..###.
