###p#.......
r.#r..#.###X
..e.##..rr##
##....%###.p
%#..%#%%....
%###%%#%##e#
%%%%%%#%#..#
%###%%%%%%.#
r#%%%%%%##.#
##%####.##..
#%%#..e.##.r
####r.######
