###%#%%......
r.#%%%#.###X.
..e%##..rr##.
##%%%.e###.p.
%#%%%#.%.....
%###%%#%##e#.
%%%%%%#%#..#.
%###%%%%%%.#.
%#%%%%%%##.#.
##%####.##...
#%%#..e.##.r.
####r.######.
