#%%%%%%#####.
p#%%####.....
..e%#%##.##%%
#.#%%%#..#r.%
###.#%#.##.#%
##.e.%e.##e#%
pe.#.%%#...%%
#..##.%#%%%%.
##r###%%%#.#.
#r###..###p#.
..#.e.######.
.....#######.
