r######.r#%%%
.#.......#%%%
.#....#e##%%%
e#e####%%#%%%
......##%#%%%
r#......%%%%%
.########%##%
.#r.r#p.#%p#%
.#...#..#%.#%
r##e###e##.#.
....#X#....#.
###...e.####.
