p..e##.....#
###....###.r
%%..####p.e#
%%##r#r###..
%##..#.#.##.
%.##...#....
.#r##..e.#e#
.e..#.###..#
#.#e..#..r.#
.e...##...##
p.##.###.#X.
##p..#r....#
