.%%#r##e...#.
#%##.#..#pp#.
#%.%%%%..###.
.%.%##%.####.
.%%%##%##r##.
r##.##%.#....
#e###r%%%#e..
...###pe%%.#.
##r...e##%%%.
###.#####.%%.
##.e..p#%#%#.
r..#..##%%%#.
