p#r...###r.#
.##...p#...#
.....e#....r
#..##...#..#
%###...##e.#
%%e..#....##
#%#.#p%##%##
#%#.##%%%%##
.%%%%%%#%%%%
%%%######%%%
%#.#########
%.p#########
