#####r%#####
####%#%####r
##%#%%%%%%#r
##%#%#%%#%..
##%%%#%%%%..
##%%#%%%%%..
r###%%#%###p
..##%###eX##
..r#%%...###
##..%###e###
#pe.####r###
##....######
