p#r#.p.##...
.#.#...##..r
.e.###.%%...
#.###%#%####
#.##%%%%%%%#
#.%#%##r#%##
#.%%%.##%%%%
#..r#..#%%##
#####.#.%%e.
#..e.....#..
#r.#.###e#.p
#..e.#p..###
