p#%%%%###r.#.
.##%%%%#...#.
..%%%%#....r.
#%%##%..#..#.
r###.%%##e.#.
e.e..#%...##.
#.#.#%%##.##.
#r#.##%%%%##.
.e..e.r#.%%r.
...######%%%%
.#.#########.
X.p#########.
