p#r...###%.#
.##...p#%%%#
.....e#%%%%%
#..##%%%#%%#
r###%%%##%%#
e.%%%#%%%%##
#.#%#p%##%##
#r#%##...%##
.e.%%.r#.%.r
...######%..
.#.#########
X.p#########
