p..e##%%%%%#.
###%%%%###%%%
.%%%####p%%#%
%%##r#r###%%%
.##..#.#.##%%
e.##...#.....
.#r##..e.#e#.
.e..#.###..#.
#.#e..#..r.#.
.e...##...##.
p.##.###.#X..
##p..#r....#.
