###p#........
r.#r..#.###X.
..e.##..rr##.
##....e###.p.
p#...#.......
e###.p#.##e#.
...e..#.#..#.
e###.......#.
r#%%....##.#.
##%####.##...
#%%#..e.##.r.
####r.######.
