p#r#.p.##....
.#.#...##..r.
.e.###.e.....
#.###r#.####.
#.##....e.r#.
#%%#.##r#%##.
#%%%%%##%%%%%
#.%r#%.#%%##%
#####%#%%%%%%
#..e.%%%%#%%%
#r.#.###e#%%%
#..e.#p..###%
