p..e##.....#.
###....###.r.
%%..####p.e#.
%%##r#r###...
%##..#.#.##..
%.##...#.....
%#r##%%%%#e#.
%%%%#%###..#.
#.#%%%#..r.#.
.e.%%##...##.
p.##%###.#X..
##%%%#r....#.
