.p#%#%%##.##.
..#%%%%%%.##.
%##%%##%%%##.
%%%%#r%%%.##.
%#%###%##e.#.
%%###p.p#..#.
.%#..#.##..#.
#%#..##r..##.
#%.e.....e.r.
%%e#....#..#.
%#...#####.#.
%..r...X##.p.
