###p#.......
r.#r..#.###X
..e.##..rr##
##....e###.p
p#...#......
%###%%#.##e#
%%%%%%#%#..#
%###%%%%%%.#
r#%%%%%%##.#
##%####.##..
#%%#..e.##.r
####r.######
