r######.r#%%
.#.......#%%
.#....#e##%%
e#e####pp#%%
......##e#%%
r#.......%%%
.########%##
.#r.r#%%#%%#
.#...#%%#%%#
r##e###%##%#
...%#%#%%%%#
###%%%%%####
