#%%%%%r#####%
%#%%####%%%%%
%%%%#%##%##%%
#%#%%%#%%#%%%
###%#%#%##%#%
##.e.%%%##%#%
pe.#...#%%%%%
#..##..#%%%%%
##r###..%#%#%
#r###..###%#%
..#.e.######.
.....#######.
