###%#%%%%...
r%#%%%#%###X
%%%%##.%%r##
##%%..e###.p
p#%%%#......
e###%%#.##e#
%%%%%%#%#..#
e###%%%%%..#
r#%%%%%.##.#
##%####.##..
#%%#..e.##.r
####r.######
