####.#r.#.p#.
r###..#.#..#.
.#..#.....##.
..#...##..##.
#.#...####r#.
%%#%#.e.r.e..
%%%%#.##..#..
%##%%p#pe.X..
%#%#####.##r.
%%%%##...###.
%#%#.##.####.
p#%%%#######.
