%#r#.%%##...
%#%#..%##..r
%%%###%%....
#%###%#%####
#%##%%%%%%r#
#%%#%##%#%##
#%%%%%##...X
#%%%#%%#..##
#####%#...e.
#..e.....#..
#r.#.###e#.p
#..e.#p..###
