###p#........
r.#r..#.###%%
..e.##..rr##%
##.%%%e###%%%
p#.%%#....%..
e###%%#.##%#.
...e%%#.#.%#.
e###%%%%%%%#.
r#%%%%%%##.#.
##%####.##...
#%%#..e.##.r.
####r.######.
