.p#.#.%##%##
..#r.e%%%%##
.##..##%%%##
....#%%%%%##
e#.###%##%%#
.r###p%%#%%#
.r#..#.##%%#
#.#..##%%%##
#..e..%%%%%%
..e#..%%#%%#
.#...#####%#
e..r...X##%%
