p#r#.p.##....
.#.#...##..r.
.e.###.e.....
#.###r#.####.
#.##....e.r#.
#.%#.##r#e##.
#%%%%%##.%%%.
#..r#%%#%%##.
#####%#.%%%..
#..e%%%%%#...
#r.#.###%#.p.
#..e.#%%%###.
