###p#%%%%%%.
r.#%%%#%###X
..%%##%%%r##
##%%%.%###.p
p#%%%#%%%...
%###%%#%##e#
%%%%%%#%#..#
%###%%%%%..#
r#%%%%%%##.#
##%####.##..
#%%#..e.##.r
####r.######
