p#r%%%###r.#.
.##%%%p#...#.
....%%#....r.
#..##%%.#..#.
r###..%##e.#.
e.e..#%...##.
#.#.#%%##.##.
#r#.##%%%%##%
.e..e.%#%%%%%
...######%%%%
.#.#########%
X.p#########%
