#####r.#####.
####%#%####r.
##%#%%%%%%#%%
##%#%#%%#%%%%
##%%%#%%%%%%%
##%%#%%%%%%%%
r###%%#%###%%
..##%###eX##%
..r#.....###%
##..e###e###%
#pe.####r###.
##....######.
