###p#..%%...
r.#r..#%###X
..e.##%%rr##
##%%%%%###.p
p#%%%#%%%...
e###%%#%##e#
%%%%%%#%#..#
e###%%%%%..#
r#%%%%%%##.#
##%####%##..
#%%#..e.##.r
####r.######
