p..e##%%%%%#%
###%%%%###%%%
%%%%####p.e#%
%.##r#r###..%
.##..#.#.##.%
e.##...#....%
.#r##..e.#e#%
.e..#.###..#%
#.#e..#..r.#%
.e...##...##%
p.##.###.#%%%
##p..#r....#%
