#%%%e.r#####.
p#.%####.....
..e%#p##.##%.
#.#%%%#..#r%%
###.#%#.##.#%
##.e.%e.##e#%
pe.#.%%#...%%
#..##%%#%%%%.
##r###%%%#.#.
#r###.%###p#.
..#.e.######.
.....#######.
