#####r.#####
####%#%####r
##%#%%%%ep#r
##%#%#%%#...
##%%%#%%%...
##%%#%%%%...
r###%%#%###p
..##%###eX##
..r#%%%%.###
##.%%###e###
#pe.####r###
##....######
