###p#.......
r.#r..#.###X
..e.##..rr##
##....e###%%
p#...#%%%%%%
e###%%#%##%#
...e%%#%#%%#
e###%%%%%%%#
r#%%%%%%##%#
##%####%##%%
#%%#..e%##.%
####r.######
