.%%#%##%%%%#
#%##%#%%#%%#
#%%%%%%%%###
%%%%##%%####
%%%%##%##r##
r##%##%%#...
#e###re%%#e.
...###p%%%%#
##r...e##%%%
###.#####%%%
##.e..p#X#%#
r..#..##..%#
