.p#.#.%##%##.
..#r.e%%%%##.
.##..##.%%##.
....#r.e%%##.
e#.###.##%%#.
.r###p.p#.%#.
.r#..#.##%%#.
#.#..##%%%##.
#..e%%%%.e.r.
..e#%...#..#.
.#..%#####.#.
e..r%%%%##.p.
