#####%%#####.
####%#%####r.
##%#%%%.ep#r.
##%#%#%.#....
##%%%#%......
##%%#%%%.....
r###%%#%###p.
..##%###%%##.
..r#%%%%%###.
##..e###e###.
#pe.####r###.
##....######.
