.%%#r##e...#.
#%##.#..#pp#.
#%%%%%%%.###.
..%%##%%####.
..%%##%##r##.
r##.##%.#....
#e###r%%%#e..
...###p%%%%#.
##r...e##%%r.
###.#####.%..
##.e..p#%#%#.
r..#..##%%%#.
