%#%%%.###r.#.
%##%%.p#...#.
%%%%%%#....r.
#..##%..#..#.
r###.%%##e.#.
e.e..#%%%%##.
#.#.#pe##%##.
#r#.##...%##%
.e..e.r#%%%%%
...######%%%%
.#.#########.
X.p#########.
