##r..#####.p
####.#%###..
#.r#.#%%%#%.
#e#.e%%#%%%#
p...#%%##%##
#e##..#p#%%%
.....##%#%#%
r.##.##%%%##
..##r#X#%%##
#ep##..#%###
#...e..#%###
######.#%%##
