#%%%e.r#####.
p#%%####.....
.%%%#p##.##X.
#.#r..#..#r..
###.#.#.##.#.
##.e..e.##e#.
pe.#...#...r.
#..##..#e..r.
##r###...#.#.
#r###..###p#.
..#.e.######.
.....#######.
