.%%#r##e...#.
#%##.#..#pp#.
#%%%%%%%.###.
%%%%##%%####.
%%%%##%##r##.
%##%##%.#....
#e###r%%%#e..
...###p%%%.#.
##r...e##%%r.
###.#####%%..
##.e..p#%#%#.
r..#..##%%%#.
