%%%#%##e...#.
#%##%#..#pp#.
#%%%%%%%.###.
%%%%##%%####.
%%..##%##r##.
%##.##%%#....
#e###%%%%#e..
...###%e%%.#.
##r...e##%.%.
###.#####%%%.
##.e..p#%#%#.
r..#..##%%%#.
