##r..#####.p.
####.#r###...
#.r#.#...#...
#e#.e..#...#.
p...#..##.##.
#e##..#p#%e..
.....##e#%#r.
r.##.##%%%##.
..##r#X#%%##.
#ep##..#%###.
#...e..#%###.
######.#%%##.
