%#r...###r.#
%##.%%%#...#
%%%%%%#....r
#%%##%%%#..#
r###%%%##e.#
e%%%%#%%%%##
#%#%#%%##%##
#%#%##%.%%##
%%%%%%%#.%.r
%..######%..
.#.#########
X.p#########
