%%%%##.....#
###%%%.###.r
%%%%####p.e#
%%##r#r###..
%##..#.#.##.
%%##...#....
%#%##..e.#e#
%%%%#.###..#
#.#%..#..r.#
.e...##...##
p.##.###.#X.
##p..#r....#
