p..e##.....#.
###....###.r.
%%%.####p.e#.
%%##r#r###...
%##..#.#.##..
%.##...#.....
%#r##..e.#e#.
%%..#.###..#.
#%#e..#..r.#.
%%...##...##.
%%##.###.#X..
##p..#r....#.
