%%%#%##e...#
#%##%#..#pp#
#%%%%%%..###
%%%%##%.####
....##%##%##
r##.##%%#%%%
#e###%%%%#%%
...###%%%%%#
##r...e##%%%
###.#####%%%
##.e..p#X#%#
r..#..##...#
