p#r#.p.##...
.#.#...##..r
%%%###.e....
#%###%#.####
#%##%%..e.r#
#%%#%##r#e##
#%%%%.##...X
#%%r#..#..##
#####.#...e.
#..e.....#..
#r.#.###e#.p
#..e.#p..###
