p#r...###r.#
.##...p#%%%#
.....e#.%%%%
#..##.%.#%%#
%###%%%##%%#
%%%%%#%%%%##
#.#%#p%##%##
#r#%##..%%##
.e%%%.r#%%%r
..%######%%.
.#%#########
X.p#########
