.p#.#%%##.##
..#r%%%%%%##
.##..##%%%##
....#r.e.%##
e#.###.##%%#
.r###p.p#%%#
.r#..#.##%%#
#.#..##%%%##
#..e.%%%%%%%
..e#.%%%#%%#
.#...#####%#
e..r...X##%%
