#####r.#####.
####.#e####r.
##%#%%%%%%#r.
##%#%#..#%%%.
##%%%#%%%%%%.
##p%#.%%%%%%.
r###e.#%###%%
..##.###eX##%
..r#.....###.
##..e###e###.
#pe.####r###.
##....######.
