p#r...###%%#
.##%%%%#%%%#
...%%%#%%%%%
#..##%%%#%%#
r###%%%##%%#
e.e.%#..%%##
#.#.#p%##%##
#r#.##%%%%##
.e..e%%#%%%%
...######%%%
.#.#########
X.p#########
