###p#.......
r.#r..#.###X
..e.##..rr##
##....e###.p
p#..%#......
%###%%#.##e#
%%%%%%#.#..#
%###%%%....#
%#%%%%%%##.#
##%####.##..
#%%#..e.##.r
####r.######
