r######.r#%%
.#%%.....#%%
.#%%%%#e##%%
e#%####pp#%%
.%%%%%##%#%%
r#%%%%%%%%%%
.########%##
.#r.r#p.#.p#
.#...#..#r.#
r##e###e##.#
....#X#....#
###...e.####
