###p#........
%%#r..#.###X.
%%%%##..rr##.
##%%%%e###.p.
p#%%%#.......
e###%%#.##e#.
...e%%#.#..#.
e###%......#.
r#%%%...##.#.
##%####.##...
#%%#..e.##.r.
####r.######.
