p#r...###r.#
.##...p#...#
.....%#....r
#..##%%.#..#
r###.%%##e.#
e%%%.#%%%%##
#%#%#p%##%##
#%#%##%%%%##
.%%%%%%#%%%%
...######%%%
.#.#########
X.p#########
