r######.r#%%.
.#.......#%%.
.#....#e##%%.
e#e####%%#%%.
..%%%%##%#%%%
r#.%%%%%%%%%%
.########%##.
.#r.r#p.#%%#.
.#...#..#r.#.
r##e###e##.#.
....#X#....#.
###...e.####.
