.p#.#%%##.##.
..#%%%%...##.
.##%%##...##.
%%%%#r.e..##.
%#%###.##e.#.
%%###p.p#..#.
%%#%%#.##..#.
#%#%%##r..##.
#%.e%....e.r.
%%%#%...#..#.
%#%%%#####.#.
%%%%%..X##.p.
