#%%%%.r#####
p#%%####....
%%%%#p##.##X
#%#%%%#%%#r.
###%#%#%##.#
##%%%%%%##e#
%%%#%%%#...r
#%%##%%#e..r
##%###%..#.#
#r###%%###p#
..#.%%######
.....#######
