%%%#r##e...#.
#%##.#..#pp#.
#%%%%%%%%###.
..%%##%%####.
...%##%##r##.
r##.##%.#....
#e###r%%%#e..
..%###%%%%%#.
##%%%%%##%%%.
###%#####%%..
##%%%.p#X#e#.
r.%#..##...#.
