####.#r.#.p#.
%###..#.#..#.
%#..#.....##.
%%#...##..##.
#%#...####r#.
%%#.#%%%%%e..
%%%%#%##%%#..
%##%%%#pe%%..
%#%#####.##r.
%%%.##...###.
%#%#%##.####.
%#%%%#######.
