#%%%%%%#####
p#%%####....
..e%#%##.##X
#.#%%%#%%#r.
###%#%#%##.#
##%%%%%%##%#
pe.#%%%#%%%r
#..##%%#%%%r
##r###%%%#.#
#r###..###p#
..#.e.######
.....#######
