###p#.......
r.#r..#%###X
..e.##%%%%##
##...%%###.p
p#...#%%%%%.
%###%%#%##e#
%%%%%%#%#..#
%###%%%%...#
r#%%%%%%##.#
##%####.##..
#%%#..e.##.r
####r.######
