.%%#%##e...#
#%##%#..#pp#
#%%%%%%%.###
%%%%##%%####
%%%%##%##r##
%##%##%.#...
#e###r%..#e.
...###%e...#
##r...e##..r
###.#####...
##.e..p#X#e#
r..#..##...#
