p..e##.....#.
###....###.r.
.r..####p.e#.
%.##r#r###...
%##..#.#.##..
%.##.%.#.....
%#r##%%%.#e#.
%%..#%###..#.
#%#%%%#..r.#.
.%%%%##...##.
p.##%###.#X..
##p.%#r....#.
