#####r.#####.
####%#e####r.
##%#%%%%%%#r.
##%#%#..#%%.%
##%%%#%%%%%%%
##%%#.%%%%%%.
r###e.#r###p.
..##.###eX##.
..r#.....###.
##..e###e###.
#pe.####r###.
##....######.
