###p#%%%.....
%%#%%%#%###X.
%%%%##%%%%##.
##%%..e###.p.
p#.%%#.......
e###%p#.##e#.
.%%%%.#.#..#.
e###%%%%...#.
r#%%%%%%##.#.
##%####.##...
#%%#..e.##.r.
####r.######.
