r######.r#.E
.#.......#..
.#....#m##..
m#m####pp#..
......##m#..
r#..........
.########m##
.#r.r#p.#.p#
.#...#..#r.#
r##m###m##.#
....#X#....#
###...m.####

