##r..#####.p
####.#r###..
#.r#.#...#..
#m#.m..#...#
p...#..##.##
#m##..#p#.m.
.....##m#.#r
r.##.##...##
..##r#X#.r##
#mp##..#m###
#...m..#.###
######.#.E##

