..E#r##m...#
#.##.#..#pp#
#........###
....##..####
....##.##r##
r##.##..#...
#m###rm..#m.
...###pm...#
##r...m##..r
###.#####...
##.m..p#X#m#
r..#..##...#

