p#r...###r.#
.##...p#...#
.....m#....r
#..##...#..#
r###...##m.#
m.m..#....##
#.#.#pm##.##
#r#.##....##
.m..m.r#...r
...######E..
.#.#########
X.p#########

